8 19
###########_______.
#.........########.
#................1.
#...P..........2.1.
#................1.
#.........########.
###########_______.